***#*******#*****#*#***************************#*#
##*###*###*#*###*#*#*#####################*###*#*#
##*******#*#*#***#*****#*********#*******#*#*#***#
########*#*#*#*###*#####*#######*#*#####*#*#*###*#
##*******#***#*#*****#***#***#*#***#***#***#*****#
##*#####*#####*###*###*###*#*#*#####*#######*#####
##***********#***#*#***#***#*******#***#*****#***#
####*#*#####*###*###*###*#########*###*#*#####*#*#
##***#*********#***#***#*#*******#*****#*#*****#*#
##*###########*###*###*#*#####*#######*#*###*###*#
##*******#***#***#*****#*****#*******#*#***#*#*#*#
##*#######*#*###*###########*#*#####*#*###*#*#*#*#
##*#*******#*#*******#*******#*****#***#*#***#***#
##*#*#######*#*#####*#*###########*#####*#####*###
##*#*****#*#*#*#***#***********#*#*******#***#***#
##*#####*#*#*#*#*#*#####*#####*#*#######*###*###*#
##***#***#*****#*#***********#*****#***********#*#
####*#*#################*###*#####*#*#########*#*#
##***#***********#*****#*#*#*#***#*#***#*****#*#*#
##*#############*#*###*#*#*#*#*#*###*###*###*#*#*#
##*****#*******#*#***#*#***#*#*#*****#***#***#*#*#
######*#*###*###*###*#*###*#*#*#######*###*#####*#
##***#*#*#*#*#*****#*#*#***********#***#***#*****#
##*###*#*#*#*#*###*#*#*#######*#####*###*###*#####
##*#*****#***#*#*#*#*#*******#*#***#***#*****#***#
##*#*#####*###*#*#*#*#######*#*#*#*###*#######*#*#
##***#***#*#***#***#*****#*#*********#*#*#*****#*#
##*###*#*###*###########*#*#########*#*#*#*###*#*#
##*#***#*****#*********#*****#*****#*#*#***#***#*#
####*#######*#*###*#########*#*#####*#*#*###*###*#
##***#***#***#*#*#*******#*****#***#*#*#***#*#***#
##*#*#*#*#####*#*#####*###*#####*#*#*#*###*#*#*###
##*#*#*#*#***#***#***#***#*#*****#*******#*#*#*#*#
##*###*#*#*#*###*#*#####*#*#*###########*###*#*#*#
##*#***#***#***#*#***#***#*#***********#*****#***#
***#*#######*###*###*#*#*#*#########*####*######*#
##*#***#***#*#***#***#*#*#*****#***#*********#***#
##*###*###*#*#*###*###*#*#####*###*###*###*#*#*###
##***#*****#***#*****#*#*****#***#***#*#***#***#*#
##*#######*#########*#*#####*###*#*#*#*#*#######*#
##*******#*#*******#*#*****#*#***#*#*#*#*****#***#
##*###*###*###*#*#*#*#####*###*#####*#*#####*#*#**
##***#***#***#*#*#*#*****#***#*******#*****#*#*#*#
####*#*#*###*###*#*#*###*###*#######*#*###*#*###*#
##***#*#***#*****#*#*#***#*#*******#*#***#*#*****#
##*###*###*#######*#*#*###*#*#######*###*####*##*#
##*******#***********#*****#***********#****#*****
